00000000000000000000
00000000000000001000
00000000000000001000
11101111111100001000
11100000000000001000
11111111111110001000
01000000000000000000
01000000000111111111
01000000000111111111
01000011111111111111
01000011111000000000
01000011111000000000
01000000000000000000
