01111111100000000000
01111111101111111110
01111111101111111110
01111111101111111110
01111111101111111110
01111111101111111110
01111111101111111110
01111111101111111110
01111111101111111110
01111111101111111110
01111111101111111110
01111111101111111110
00000000001111111110
